##############################
##.##........#.#....#...M#..T#
#.K.#.#.#......#.##..#.###.###
##.##..#..###..#.#..#..#...#.#
##...#.#.......#.#.##....#.#.#
##.#....#.#.#.#.......##.###.#
##..##.##.#.#.##.###.##......#
###M.....#..#..#.#.#.#...#.###
#..#.##.##.#.....#...#.###.#.#
##.#.#......##.###.###.#.....#
##...#.##.#..#...........#.#.#
#...#.#...##.##.#####.#.##.###
##......#..#.#..#...###......#
#..#.#.###....#.#.#P....#.##.#
###################D##########